111111111111
1P000000E001
1C0000000001
111111111111