1111111111111
1000000000001
101P101011101
1010100000001
1010101011101
101C000000001
1011110101101
1000000100101
1011110110101
100000000E001
1111111111111